000000000000000000000000000000000000000000000000000000000000000000000000000000
000000000g0e0gP00g0g00fgg0g000000000000000000000000000000000000000000000000000
000000000211113xy21111113a0000000000000000000000000000000000000000000000000000
000000000466668ll4666666800000000000000000000000000000000000000000000000000000
000000000599997ll5999999700000000000000000000000000000000000000000000000000000
000000000000000ll0000000000000000000000000000000000000000000000000000000000000
000000000000000ll0000000000000000000000000000000000000000000000000000000000000
0000pppppppppppllpppppppppp000000000000000000000000000000000000000000000000000
000021111111111111111111113000000000000000000000000000000000000000000000000000
000046666666666666666666668000000000000000000000000000000000000000000000000000
000059999999999999999999997000000000000000000000000000000000000000000000000000

