000000000000000000000000000000000000000000000000000000000000000000000000000000
000000000g0ePg00000g00fgg0g000000000000000000000000000000000000000000000000000
000000000211113xy21111111113a000000000000000000000000000000000000000000000000+
000000000466668ll466666666680000000000000000000000000000000000000000000000000+
000000000599997ll599999999970000000000000000000000000000000000000000000000000+
000000000000000ll0000000000000000000000000000000000000000000000000000000000000
0000000sssssss0ll0000000000000000000000000000000000000000000000000000000000000
000pp00ppppppppllppppppppp0000000000000000000000000000000000000000000000000000
00023xy2111111111111111111300000000000000000000000000000000000000000000000000+
00048ll4666666666666666666800000000000000000000000000000000000000000000000000+
00057ll5999999999999999999700000000000000000000000000000000000000000000000000+
00000ll00000000000000000000000000000000000000000000000000000000000000000000000
00000ll00000000000000000000000000000000000000000000000000000000000000000000000
00000ll00000000000000000000000000000000000000000000000000000000000000000000000
00000ll00000000000000000000000000000000000000000000000000000000000000000000000
00000ll00000000000000000000000000000000000000000000000000000000000000000000000
00000ll00000000000000000000000000R00000000000000000000000000000000000000000000
00000ll00000000000000000000000000000000000000000000000000000000000000000000000
00000ll0N000NS0N00000000000W0000000000000000000000000000000000000000000000000
00002111111111111111111111111111111111113000000000000000000000000000000000000-
00004666666666666666666666666666666666668000000000000000000000000000000000000-
00005999999999999999999999999999999999997000000000000000000000000000000000000-
000000000000000000000000000000000000000000000000000000000000000000000000000000
000000000000000000000000000000000000000000000000000000000000000000000000000000
000000000000000000000000000000000000000000000000000000000000000000000000000000
000000000000000000000000000000000000000000000000000000000000000000000000000000
000000000000000000000000000000000000000000000000000000000000000000000000000000
000000000000000000000000000000000000000000000000000000000000000000000000000000
000000000000000000000000000000000000000000000000000000000000000000000000000000




