
00000000000000000000000000000000000000000000000000000000000000000000000000000000000000000000000000000000000000000000000000000000000000000000000000000000
00000000000000000000000000000000000000000000000000000000000000000000000000000000000000000000000000000000000000000000000000000000000000000000000000000000
00000000000000000000000000000000000000000000000000000000000000000000000000000000000000000000000000000000000000000000000000000000000000000000000000000000
00000000000000000000000000000000000000000000000000000000000000000000000000000000000000000000000000000000000000000000000000000000000000000000000000000000
00000000000000000000000000000000000000000000000000000000000000000000000000000000000000000000000000000000000000000000000000000000000000000000000000000000
00000000000000000000000000000000000000000000000000000000000000000000000000000000000000000000000000000000000000000000000000000000000000000000000000000000
00000000000000000000000000000000000000000000000000000000000000000000000000000000000000000000000000000000000000000000000000000000000000000000000000000000
00000000000000000000000000000000000000000000000000000000000000000000000000000000000000000000000000000000000000000000000000000000000000000000000000000000
00000000000000000000000000000000000000000000000000000000000000000000000000000000000000000000000000000000000000000000000000000000000000000000000000000000
00000000000000000000000000000000000000000000000000000000000000000000000000000000000000000000000000000000000000000000000000000000000000000000000000000000
00000000000000000000000000000000000000000000000000000000000000000000000000000000000000000000000000000000000000000000000000000000000000000000000000000000
00000000000000000000000000000000000000000000000000000000000000000000000000000000000000000000000000000000000000000000000000000000000000000000000000000000
00000000000000000000000000000000000000000000000000000000000000000000000000000000000000000000000000000000000000000000000000000000000000000000000000000000
00000000000000000000000000000000000000000000000000000000000000000000000000000000000000000000000000000000000000000000000000000000000000000000000000000000
00000000000000000000000000000000000000000000000000000000000000000000000000000000000000000000000000000000000000000000000000000000000000000000000000000000
00000000000000000000000000000000000000000000000000000000000000000000000000000000000000000000000000000000000000000000000000000000000000000000000000000000
00000000000000000000000000000000000000000000000000000000000000000000000000000000000000000000000000000000000000000000000000000000000000000000000000000000
00000000000000000000000000000000000000000000000000000000000000000000000000000000000000000000000000000000000000000000000000000000000000000000000000000000
0000000000000000000000000000000000000000P000000000000000000000000000000000000000000000000000000000000000000000000000000000000000000000000000000000000000
00000000000000000000000000000000000000002000000000000000000000000000000000000000000222220220000000000000000000000000000000000000000000000000000000000000
00000000000000000000000000000000000000021100000000000000000000000000000000000000002111112111000000000000000000000000000000000000000000000000000000000000
00000000000000000000000000000000000000211100000000000000000000000000000000000000021111111111000000000000000000000000000000000000000000000000000000000000
000000000000000000000000000000000000021111111C0000000000000000000000000C00000000211111111100000000000000000000000000000000000000000000000000000000000000
00000000000000000000000000000000000221111111111111111100000000000000222222222220000000000000000000000000000000000000000000000000000000000000000000000000
00000000000000000000000000000000002111111111111111110000000000000222111111111100000000000000000000000000000000000000000000000000000000000000000000000000
20000000000000000000000000000000021111111111111100000000000000002111111111000000000000000000000000000000000000000000000000000000000000000000000000000000
10000000000000000000000000000021111111100000000000000000000002111111110000000000000000000000000000000000000000000000000000000000000000000000000000000000
12200000000000000000000000000000000000000000000000000000000000211111000000000000000000000000000000000000000000000000000000000000000000000000000000000000
111200000000000000000000000000000000C0000000000000022222221000000000000000000000000000000000000000000000000000000000000000000000000000000000000000000000
1111222222200000000000000000000022222222222222222212211111110000000000000000000000000000000000000000000000000000000000000000000000000000000000000000000
11111111111200000000000000000211111111111111111111111111111110200000000000000000000000000000000000000000000000000000000000000000000000000000000000000000
00011111111100000000000000021111111111111111111111111111111112220000000000000000000000000000000000000000000000000000000000000000000000000000000000000000
00000111111122200000200000211111111111111111111111111111111111112000000000000000000000000000000000000000000000000000000000000000000000000000000000000000
00000000000000000002100002111111111111111111111111111111111111111200000000000000000000000000000000000000000000000000000000000000000000000000000000000000
00000000000000000000000000000000000000000000000000000000000000000000000000000000000000000000000000000000000000000000000000000000000000000000000000000000
00000000000000000000000000000000000000000000000000000000000000000000000000000000000000000000000000000000000000000000000000000000000000000000000000000000
